111111111111111111111
111111110000001111111
110000000000000001111
100000000000C00000011
10S000000000000000001
1000C00S0111100000001
100000000111110000001
100000000111110000001
100000000111100000001
100000000011100000001
11000000000000000S001
110S00110000000000001
1110000110000000E0001
1111000110P000C000001
111111111111111111111
