111111111111111111111
111001110000001111111
110000100001100111111
110000001111110001111
11111000111111100C011
111110011111111000011
110000011111111000011
1000F0011111111000011
100000011111110000011
100001000000000000111
110011111000000011111
111111111111111111111
111111111111111111111
111111111111111111111
111111111111111111111
