1111111111111
111000E001111
1000000011111
10C0000011C11
100000P001001
1100000000001
1110000000001
1111111111111
