1111111111111
100000E000001
1000000000001
100000000C001
1000000000001
1000000000001
10P0000000F01
1000000000001
1111111111111
