111111111111111111
111101011000011111
110000000000000111
100P000000F00C0011
100000000000000001
110000C00000000001
110000000000C00011
100000000000000011
100110000010000111
111111000011100111
111111100001101111
111111111111111111
