11111111111111
100001E1000001
10C000C000C001
10000000000001
10000000000001
10000000000001
100000P0000001
10000000000001
11111111111111
