111111111111111111
111100011000011111
110000000000000111
100P000C0000001111
1000000000000C0111
110000F00100000111
111000001110000111
11100C011111001111
111110011111111111
111111111111111111
111111111111111111
111111111111111111
