11111111111111
10000000000001
10P00000001C01
10000000011101
10000000111101
10000000011001
100000C0001C01
10000000000001
11111111111111
