111111111111111111
111101011000011111
110000000000000111
110P00000000000011
111000000000000001
111100000000000001
111110000S00000011
111111000000000011
111111100010000111
111111110011100111
111111110001101111
111111111111111111
