111111111111111111
111101011000011111
1100000C0000000111
100P00000010000011
100000000101100001
110000C01110010001
110000000000000011
1000000000000C0011
100110000010000111
111111000011100111
111111100001101111
111111111111111111
