11111111111111
100001E1000001
10P00000000C01
10000000000001
10011000110001
10010000010001
100100C0010C01
10010000010001
11111111111111
