111111111111111111
111100011000011111
110000000000000111
100P000C0000000011
10000000000F0C0001
110000000000000001
110000000000000011
10000C000010000011
100110000111000111
111111000011100111
111111100001101111
111111111111111111
