1111111111111111
1111000011100001
1100000000000001
100P000C00000001
1000000000110C01
1000000000110001
1000000001111001
10010C0111110001
1011100111110011
1111111111111111
