1111111111111111111
1111010110000111111
11000E0000000001111
110P000000000000111
1110000000000000011
1111000000000000011
111110000S000000011
1111110000000000011
11111110C0100001111
1111111100111001111
1111111100011011111
1111111111111111111
1111111111111111111

