111111111111111111
111111111100111111
11111E110000111111
111111000000111111
111111000000111111
111111110000111111
111111111110111111
111111111110111111
111111111111111111
111111111111111111
111111111111111111
111111111111111111
