111111111111111111
111111111111111111
111111111111111111
111111111111111111
111111111111111111
111111111111111111
111111111111111111
111111110111111111
111111111111111111
111111111111111111
111111111111111111
111111111111111111
