111111111111111111
111111111111111111
111111100111111111
111111000001111111
111111000000111111
111111110011111111
111111111111111111
111111111111111111
111111111111111111
111111111111111111
111111111111111111
111111111111111111
