1111111111111111111
1111111111001111111
11111E1100001111111
1111110000001111111
1111110000001111111
1111111100001111111
1111111111101111111
1111111111101111111
1111111111111111111
1111111111111111111
1111111111111111111
1111111111111111111
1111111111111111111
