1111111111
1000000001
1000000001
10S0110S01
1P001100C1
1111111111
