1111111111
10000E00C1
1000000001
1111111111
1111111111
1111111111
