1111111111
1000000001
1000000001
10S0110001
1P001100C1
1111111111
