1111111111
1011111111
1111111111
1111111111
1111111111
1111111111
