1111111111
10000EP0C1
1S00000001
1111111111
1111111111
1111111111
