1111111111
1000E00001
1000000001
1111111111
1111111111
1111111111
