1111111111
1000000001
1000000001
1SS0000S01
10001100C1
1111111111
